Agamaggan - PvP Server
    Moriyana    - Night Elf - Rogue     - Alliance

Anub'arak - PvP Server
    Sindryssa   - Blood Elf - Warlock   - Horde
    Menayash    - Blood Elf - Hunter    - Horde
    Euphalya    - Undead    - Warlock   - Horde

Blackwater Raiders:
    Nyissana    - Human     - Rogue     - Alliance
    Kalashandra - Human     - Warlock   - Alliance

Eonar
    Sallar      - Draenei   - Hunter    - Alliance  - male

Farstriders
    Irislaynya  - Undead    - Mage      - Horde - Herbalism, Inscription            - twin of Shaunyalla
    Klahraka    - Orc       - Rogue     - Horde - Mining(right now)                 - with Bill
    Shaunyalla  - Undead    - Warlock   - Horde - Alchemy, Herbalism                - twin of Irislaynya
    Svetyala    - Tauren    - Shaman    - Horde - Blacksmithing, Engineering
    Teschyan    - Blood Elf - Paladin   - Horde - Mining, Tailoring
    Zroteyla    - Troll     - Hunter    - Horde - Mining, Skinning(right now - convert to Jewelcrafting)

Khaz Modan:
    Irishkah    - Night Elf - Rogue     - Alliance
    Celanya     - Night Elf - Hunter    - Alliance
*   Anjalyque   - Human     - Warlock   - Alliance
*   Narishya    - Blood Elf - Warlock   - Horde
*   Shaunyakla  - Undead    - Mage      - Horde
*   Svetyala    - Tauren    - Shaman    - Horde
*   Zyarinya    - Draenei   - Warrior   - Alliance

Sentinels
    Selatia     - Draenei   - Shaman    - Alliance

The Scryers
*   Anjalyque   - Human     - Warrior   - Alliance - Herbalism, Inscription
*   Chianleya   - Draenei   - ??        - Alliance - Blacksmithing, Engineering     - sister to Chiantla
*   Chiantla    - Draenei   - ??        - Alliance - Mining, Jewelcrafting          - sister to Chianleya
*   Jaleynya    - Night Elf - ??        - Alliance - Mining, Tailoring
*   Jenovyan    - Night Elf - Hunter    - Alliance - Alchemy, Herbalism
    Satyari     - Human     - Warlock   - Alliance - Mining, Skinning               - with Bill

Thorium Brotherhood:
    Nyirisha    - Undead    - Rogue     - Horde
    Erishana    - Night Elf - Rogue     - Alliance
    Arishala    - Orc       - Warlock   - Horde
    Sarahana    - Blood Elf - Mage      - Horde
    Kalahra     - Draenei   - Hunter    - Alliance
    Sindyarsa   - Blood Elf - Warlock   - Horde

Open Names: zahrayana, iryarasha, klahra'aka, zaritheya, zhevya



WoW friends lists:

Shelley:
    Sentinals
        Dimonica (warlock)
        Maurigan (mage)

Bill:
    Sentinals
        Coriax (warrior)
        Grimnifa (rogue)

Dave S:
    Khaz Modan
        Thevenet
        Celzig
        Neshaminy
        Haigle

Servers to check for RP
    Venture Company
    